33333333333333333333333333333333333333333333333333333333333
30022200000022222222000000000000222200000022222220000000003
30002200000000000000000000000000022000000000000000000000003
30002200000000000000000000000000022000000000000000000000003
30002200000000000000000000000000022000000000000000000000003
30002200000002200000000000000000022000000000000000000000003
30002200000002200000000000000000033000000000000000000000003
30002233333333333333333333333333333333333333330000000000003
30002200000000000000000000000000000000000000000000000000003
30002200000000000000000000000000000000000000000000000000003
32222200000002220000000000000000000000000000000333330000003
30000000000002220000000000000000000000000000000304002000003
30000000006002220000000000000000000000000000000300402000003
30000000000000000000040000000600000000400000000300002000003
30000000000002220000000000000000000000000000000033333000003
30000000000000220000000000000000000000000000000000000000003
30000000000002220000000000000000000000000000000000000000003
33333333333333333333333333333333222223333233333333333333333
30000000000000300000000000000000000000300000000000000000003
30000000000000300000000000000000000000300000000000000000003
30000004000000300000000000000000000000300000003000000000003
30000000000040300000000000000000000000300000003000000000003
32222222222222300000000000000000000000300000003060000000003
30000000000000300000000000000000000000300000003000000000003
30000000000000300000000000000000000000000000003000000000003
30000000000000300000000000000000006000000000003000000000003
30000006000000300000060000000000000000300000003000000000003
30000000000000300000000000000000000000322222222222222222223
30000000000000300000000000000000000000000000000000000000003
30000000000000333333333332222333333300000000000000000000003
30222200000022222222000000000000222200000022222222000000003
30000000000000000000000000000000000000000000000000000000003
30000000000000000000000000000000000000000000000000000000003
30000000000000000000000000000000000000000000000000000000003
30000000000000000000000000000000000000000000000000000000003
30000000000002200000000000000000000000000000000000000000003
30000000000002200000000000000000000000000000000000000000003
32222222222222200000000000000000000000000000000000000000003
30000000060000000000000000000000000000000000000000000000003
30000000000002220000000000000000000000000000000000000000003
30000000000002220000000000000600000000000000000000000000003
30000000000002220000000000000000000000000000000000000000003
30000000000000000000000000000000000000000000000000000000003
30000000000000222000000000000000002222222222220000000000003
30000000000000022000000000000000000000000000000000000000003
32222222222222222000000000000000000000000000000000000000003
30000000000000000000000000000000000000000000000000000000003
30000000000000000000000000000000000000000000000000000000003
30000000000000000000000000000002222222222222222222222222223
30000000000000000000000000000003000000006000000000000000003
32220000000060000000000000000003000000000000000000000000003
36003000000000000000000000000003000000000000000000000000003
30000000000000000000000000000003333333333333300000000000003
30003000000000000000000000000003000004000022000000000000003
33330000000000000000000000000003000004000022000000000000003
30000000000000000000000000000333000000000022000000000000003
30000000000000000000000000000003333333333330000000000000003
30000000000000000000000000000003000006000000000000000000003
30000000000000000000000000000003000000000000000000000000003
33333333333333333333333333333333333333333333333333333333333